
NO texture/pengsoo6.xpm
SO texture/pengsoo.xpm
WE texture/pengsoo3.xpm
EA texture/pengsoo5.xpm

F 240,255,255
C 255,153,153

        1111111111111111111111111
        1000000000110000000000001
        1011S01001110000000000001
        1001000000000000000100001
111111111011000001110000000000001
100000000011000001110111111111111
11110111101111011100000010001
11110111111111011101010010001
11000000110101011100000100001
10000000000000001100000000001
10000100000000001101010010001
1100000111010101110001111010111
11110111 1110101 101111110001
11111111 1111111 111111111111
