NO texture/NO.xpm
SO texture/SO.xpm
WE texture/WE.xpm
EA texture/EA.xpm
NR texture/in_wall1.xpm
SR texture/in_wall1.xpm
WR texture/in_wall1.xpm
ER texture/in_wall1.xpm
S  texture/dog1.xpm
ST texture/dog2.xpm
SU texture/dog3.xpm
SV texture/dog4.xpm
SF texture/table.xpm
DO texture/door.xpm
DC texture/open_door.xpm

F 97,144,0
C 0,191,255

1111111111111111111111111111111111111111
1000000111555555510000000000000000000001
1011000001555F55510000000000000000000001
1000000001555555510000000000000000000001
1000000001111311110000000000000000000001
1001001100000000000000000000000000000001
1110001110110000011100000000000000000001
1000000000110000011101000000000000000001
10000W0000110000011101000000000000000001
1000200000000000110101000000000000000001
1100000111010101111101100000000000000001
1100000111010101111101100000000000000001
1111111111111111111111111111111111111111
