NO texture/NO.xpm
SO texture/SO.xpm
WE texture/WE.xpm
EA texture/EA.xpm

F 97,144,0
C 0,191,255

1111111111111111111111111
1000000111110000000000001
1011000001110000010000001
1001001100000000000000001
111N001110110000011100001
1000000000110000011101001
1000000000000000110101001
1100000111010101111101101
1111111111111111111111111