NO texture/NO.xpm
SO texture/SO.xpm
WE texture/WE.xpm
EA texture/EA.xpm
NR texture/in_wall1.xpm
SR texture/in_wall1.xpm
WR texture/in_wall1.xpm
ER texture/in_wall1.xpm
S  texture/dog1.xpm
ST texture/dog2.xpm
SU texture/dog3.xpm
SV texture/dog4.xpm
SF texture/table.xpm
DO texture/door.xpm
DC texture/open_door.xpm

F 97,144,0
C 0,191,255

111111111111111111111111111111111
100000011155555551000000000000001
1011000001555F5551000000200000001
100000000155555551000000000002001
100000000111131111000000002000001
100100110000000000000002000000001
111000111011000001110000020000001
10000W000011000001110100000200001
100000000011000001110100000000001
100000000000000011010100200000001
110000011101010111110110000000001
110000011101010111110110000000001
111111111111111111111111111111111
